Trial_ID,Group_size,Fish_ID,In,Out,Duration
during-20-1512,20,0,0,3,3
during-20-1512,20,0,5,8,3
during-20-1512,20,0,10,12,2
during-20-1512,20,0,44,51,7
during-20-1512,20,0,97,98,1
during-20-1512,20,0,128,133,5
during-20-1512,20,0,145,159,14
during-20-1512,20,0,160,164,4
during-20-1512,20,0,202,206,4
during-20-1512,20,0,227,229,2
during-20-1512,20,0,240,250,10
during-20-1512,20,0,274,276,2
during-20-1512,20,0,300,303,3
during-20-1512,20,0,304,307,3
during-20-1512,20,0,318,324,6
during-20-1512,20,0,350,363,13
during-20-1512,20,0,381,384,3
during-20-1512,20,1,0,9,9
during-20-1512,20,1,14,16,2
during-20-1512,20,1,25,46,21
during-20-1512,20,1,49,53,4
during-20-1512,20,1,77,89,12
during-20-1512,20,1,125,126,1
during-20-1512,20,1,132,142,10
during-20-1512,20,1,201,203,2
during-20-1512,20,1,268,301,33
during-20-1512,20,1,302,303,1
during-20-1512,20,1,334,345,11
during-20-1512,20,1,351,367,16
during-20-1512,20,1,377,384,7
during-20-1512,20,2,0,4,4
during-20-1512,20,2,7,14,7
during-20-1512,20,2,26,28,2
during-20-1512,20,2,29,30,1
during-20-1512,20,2,42,50,8
during-20-1512,20,2,98,100,2
during-20-1512,20,2,144,160,16
during-20-1512,20,2,195,206,11
during-20-1512,20,2,216,219,3
during-20-1512,20,2,234,248,14
during-20-1512,20,2,304,316,12
during-20-1512,20,2,329,337,8
during-20-1512,20,2,351,355,4
during-20-1512,20,2,359,366,7
during-20-1512,20,2,384,386,2
during-20-1512,20,2,391,402,11
during-20-1512,20,3,5,7,2
during-20-1512,20,3,8,13,5
during-20-1512,20,3,14,16,2
during-20-1512,20,3,26,35,9
during-20-1512,20,3,47,51,4
during-20-1512,20,3,59,60,1
during-20-1512,20,3,82,100,18
during-20-1512,20,3,125,127,2
during-20-1512,20,3,168,173,5
during-20-1512,20,3,190,195,5
during-20-1512,20,3,225,227,2
during-20-1512,20,3,229,232,3
during-20-1512,20,3,250,252,2
during-20-1512,20,3,263,267,4
during-20-1512,20,3,268,270,2
during-20-1512,20,3,297,302,5
during-20-1512,20,3,304,306,2
during-20-1512,20,3,333,348,15
during-20-1512,20,3,351,355,4
during-20-1512,20,3,379,382,3
during-20-1512,20,3,390,399,9
during-20-1512,20,3,409,411,2
during-20-1512,20,4,0,13,13
during-20-1512,20,4,38,42,4
during-20-1512,20,4,48,52,4
during-20-1512,20,4,57,66,9
during-20-1512,20,4,67,85,18
during-20-1512,20,4,88,89,1
during-20-1512,20,4,124,133,9
during-20-1512,20,4,146,152,6
during-20-1512,20,4,163,168,5
during-20-1512,20,4,177,179,2
during-20-1512,20,4,183,188,5
during-20-1512,20,4,194,202,8
during-20-1512,20,4,211,212,1
during-20-1512,20,4,235,239,4
during-20-1512,20,4,240,243,3
during-20-1512,20,4,263,268,5
during-20-1512,20,4,287,289,2
during-20-1512,20,4,300,304,4
during-20-1512,20,4,320,321,1
during-20-1512,20,4,324,329,5
during-20-1512,20,4,331,337,6
during-20-1512,20,4,342,343,1
during-20-1512,20,4,349,350,1
during-20-1512,20,4,354,356,2
during-20-1512,20,4,363,367,4
during-20-1512,20,4,387,390,3
during-20-1512,20,5,0,4,4
during-20-1512,20,5,5,18,13
during-20-1512,20,5,27,31,4
during-20-1512,20,5,44,53,9
during-20-1512,20,5,56,67,11
during-20-1512,20,5,74,86,12
during-20-1512,20,5,89,95,6
during-20-1512,20,5,120,126,6
during-20-1512,20,5,131,139,8
during-20-1512,20,5,149,150,1
during-20-1512,20,5,158,159,1
during-20-1512,20,5,188,196,8
during-20-1512,20,5,197,209,12
during-20-1512,20,5,223,224,1
during-20-1512,20,5,227,229,2
during-20-1512,20,5,245,254,9
during-20-1512,20,5,312,317,5
during-20-1512,20,5,324,329,5
during-20-1512,20,5,336,342,6
during-20-1512,20,5,353,360,7
during-20-1512,20,5,379,384,5
during-20-1512,20,5,385,387,2
during-20-1512,20,5,391,395,4
during-20-1512,20,5,399,408,9
during-20-1512,20,6,0,7,7
during-20-1512,20,6,23,42,19
during-20-1512,20,6,141,173,32
during-20-1512,20,6,190,204,14
during-20-1512,20,6,273,305,32
during-20-1512,20,6,340,343,3
during-20-1512,20,6,367,369,2
during-20-1512,20,6,386,389,3
during-20-1512,20,7,3,12,9
during-20-1512,20,7,36,40,4
during-20-1512,20,7,46,49,3
during-20-1512,20,7,53,60,7
during-20-1512,20,7,62,66,4
during-20-1512,20,7,111,112,1
during-20-1512,20,7,138,145,7
during-20-1512,20,7,166,169,3
during-20-1512,20,7,193,197,4
during-20-1512,20,7,205,207,2
during-20-1512,20,7,245,250,5
during-20-1512,20,7,264,267,3
during-20-1512,20,7,302,305,3
during-20-1512,20,7,312,319,7
during-20-1512,20,7,332,338,6
during-20-1512,20,7,350,355,5
during-20-1512,20,7,390,400,10
during-20-1512,20,8,37,53,16
during-20-1512,20,8,69,83,14
during-20-1512,20,8,96,98,2
during-20-1512,20,8,155,164,9
during-20-1512,20,8,177,178,1
during-20-1512,20,8,192,198,6
during-20-1512,20,8,221,224,3
during-20-1512,20,8,308,309,1
during-20-1512,20,8,311,318,7
during-20-1512,20,8,332,337,5
during-20-1512,20,8,358,362,4
during-20-1512,20,8,387,400,13
during-20-1512,20,9,1,13,12
during-20-1512,20,9,27,29,2
during-20-1512,20,9,48,57,9
during-20-1512,20,9,58,60,2
during-20-1512,20,9,148,150,2
during-20-1512,20,9,153,158,5
during-20-1512,20,9,161,164,3
during-20-1512,20,9,263,264,1
during-20-1512,20,9,269,273,4
during-20-1512,20,9,288,306,18
during-20-1512,20,9,328,329,1
during-20-1512,20,9,339,344,5
during-20-1512,20,9,349,359,10
during-20-1512,20,9,372,376,4
during-20-1512,20,10,0,12,12
during-20-1512,20,10,27,41,14
during-20-1512,20,10,64,89,25
during-20-1512,20,10,156,165,9
during-20-1512,20,10,193,200,7
during-20-1512,20,10,239,241,2
during-20-1512,20,10,263,278,15
during-20-1512,20,10,322,329,7
during-20-1512,20,10,334,341,7
during-20-1512,20,10,350,369,19
during-20-1512,20,10,388,400,12
during-20-1512,20,10,407,414,7
during-20-1512,20,11,0,2,2
during-20-1512,20,11,6,15,9
during-20-1512,20,11,38,42,4
during-20-1512,20,11,43,87,44
during-20-1512,20,11,96,99,3
during-20-1512,20,11,121,129,8
during-20-1512,20,11,137,148,11
during-20-1512,20,11,149,152,3
during-20-1512,20,11,166,169,3
during-20-1512,20,11,187,193,6
during-20-1512,20,11,237,240,3
during-20-1512,20,11,301,302,1
during-20-1512,20,11,317,325,8
during-20-1512,20,11,326,341,15
during-20-1512,20,11,387,400,13
during-20-1512,20,11,402,403,1
during-20-1512,20,12,0,3,3
during-20-1512,20,12,7,8,1
during-20-1512,20,12,34,48,14
during-20-1512,20,12,49,57,8
during-20-1512,20,12,97,99,2
during-20-1512,20,12,139,146,7
during-20-1512,20,12,148,149,1
during-20-1512,20,12,154,157,3
during-20-1512,20,12,198,199,1
during-20-1512,20,12,200,207,7
during-20-1512,20,12,212,213,1
during-20-1512,20,12,238,241,3
during-20-1512,20,12,251,255,4
during-20-1512,20,12,272,274,2
during-20-1512,20,12,287,289,2
during-20-1512,20,12,298,305,7
during-20-1512,20,12,308,315,7
during-20-1512,20,12,321,322,1
during-20-1512,20,12,334,339,5
during-20-1512,20,12,348,349,1
during-20-1512,20,12,351,363,12
during-20-1512,20,12,379,383,4
during-20-1512,20,12,394,399,5
during-20-1512,20,13,0,10,10
during-20-1512,20,13,44,47,3
during-20-1512,20,13,61,77,16
during-20-1512,20,13,126,132,6
during-20-1512,20,13,154,158,4
during-20-1512,20,13,163,170,7
during-20-1512,20,13,244,246,2
during-20-1512,20,13,295,304,9
during-20-1512,20,13,324,327,3
during-20-1512,20,13,349,367,18
during-20-1512,20,13,378,383,5
during-20-1512,20,13,387,389,2
during-20-1512,20,13,397,408,11
during-20-1512,20,14,5,13,8
during-20-1512,20,14,21,43,22
during-20-1512,20,14,106,109,3
during-20-1512,20,14,133,172,39
during-20-1512,20,14,191,197,6
during-20-1512,20,14,262,269,7
during-20-1512,20,14,273,290,17
during-20-1512,20,14,299,300,1
during-20-1512,20,14,309,311,2
during-20-1512,20,14,312,317,5
during-20-1512,20,14,319,328,9
during-20-1512,20,14,332,343,11
during-20-1512,20,14,350,352,2
during-20-1512,20,15,40,43,3
during-20-1512,20,15,90,95,5
during-20-1512,20,15,131,132,1
during-20-1512,20,15,134,138,4
during-20-1512,20,15,193,204,11
during-20-1512,20,15,264,302,38
during-20-1512,20,15,333,344,11
during-20-1512,20,15,365,372,7
during-20-1512,20,16,0,24,24
during-20-1512,20,16,30,41,11
during-20-1512,20,16,144,150,6
during-20-1512,20,16,159,169,10
during-20-1512,20,16,193,197,4
during-20-1512,20,16,206,208,2
during-20-1512,20,16,213,217,4
during-20-1512,20,16,234,239,5
during-20-1512,20,16,255,256,1
during-20-1512,20,16,268,271,3
during-20-1512,20,16,304,310,6
during-20-1512,20,16,379,386,7
during-20-1512,20,16,396,403,7
during-20-1512,20,17,0,2,2
during-20-1512,20,17,3,7,4
during-20-1512,20,17,37,40,3
during-20-1512,20,17,192,200,8
during-20-1512,20,17,237,239,2
during-20-1512,20,17,289,293,4
during-20-1512,20,18,0,12,12
during-20-1512,20,18,32,51,19
during-20-1512,20,18,55,85,30
during-20-1512,20,18,98,99,1
during-20-1512,20,18,158,160,2
during-20-1512,20,18,161,172,11
during-20-1512,20,18,174,179,5
during-20-1512,20,18,188,191,3
during-20-1512,20,18,197,199,2
during-20-1512,20,18,201,204,3
during-20-1512,20,18,238,239,1
during-20-1512,20,18,301,304,3
during-20-1512,20,19,2,5,3
during-20-1512,20,19,8,14,6
during-20-1512,20,19,31,42,11
during-20-1512,20,19,49,52,3
during-20-1512,20,19,58,61,3
during-20-1512,20,19,66,71,5
during-20-1512,20,19,84,89,5
during-20-1512,20,19,123,124,1
during-20-1512,20,19,152,153,1
during-20-1512,20,19,154,166,12
during-20-1512,20,19,195,198,3
during-20-1512,20,19,236,240,4
during-20-1512,20,19,268,269,1
during-20-1512,20,19,271,273,2
during-20-1512,20,19,290,294,4
during-20-1512,20,19,302,308,6
during-20-1512,20,19,316,317,1
during-20-1512,20,19,329,330,1
during-20-1512,20,19,339,346,7
during-20-1512,20,19,350,359,9
during-20-1512,20,19,373,375,2
during-20-1512,20,19,380,381,1
during-20-1512,20,19,388,399,11
during-20-1512,20,19,403,406,3
during-20-1112,20,0,20,25,5
during-20-1112,20,0,37,40,3
during-20-1112,20,0,48,53,5
during-20-1112,20,0,57,67,10
during-20-1112,20,0,71,73,2
during-20-1112,20,0,132,140,8
during-20-1112,20,0,150,155,5
during-20-1112,20,0,183,185,2
during-20-1112,20,0,193,197,4
during-20-1112,20,0,218,220,2
during-20-1112,20,0,272,286,14
during-20-1112,20,0,321,323,2
during-20-1112,20,0,324,326,2
during-20-1112,20,0,376,377,1
during-20-1112,20,0,389,400,11
during-20-1112,20,1,10,19,9
during-20-1112,20,1,20,32,12
during-20-1112,20,1,37,42,5
during-20-1112,20,1,56,60,4
during-20-1112,20,1,63,68,5
during-20-1112,20,1,70,71,1
during-20-1112,20,1,80,86,6
during-20-1112,20,1,91,95,4
during-20-1112,20,1,130,135,5
during-20-1112,20,1,136,156,20
during-20-1112,20,1,275,290,15
during-20-1112,20,1,318,324,6
during-20-1112,20,1,328,332,4
during-20-1112,20,1,385,396,11
during-20-1112,20,2,20,24,4
during-20-1112,20,2,36,41,5
during-20-1112,20,2,57,70,13
during-20-1112,20,2,110,113,3
during-20-1112,20,2,129,133,4
during-20-1112,20,2,136,140,4
during-20-1112,20,2,149,155,6
during-20-1112,20,2,183,185,2
during-20-1112,20,2,193,198,5
during-20-1112,20,2,217,221,4
during-20-1112,20,2,225,238,13
during-20-1112,20,2,250,257,7
during-20-1112,20,2,308,312,4
during-20-1112,20,2,319,325,6
during-20-1112,20,2,377,380,3
during-20-1112,20,2,413,414,1
during-20-1112,20,3,7,9,2
during-20-1112,20,3,20,23,3
during-20-1112,20,3,58,65,7
during-20-1112,20,3,67,70,3
during-20-1112,20,3,79,85,6
during-20-1112,20,3,94,96,2
during-20-1112,20,3,131,153,22
during-20-1112,20,3,174,177,3
during-20-1112,20,3,189,191,2
during-20-1112,20,3,217,220,3
during-20-1112,20,3,223,226,3
during-20-1112,20,3,241,248,7
during-20-1112,20,3,274,275,1
during-20-1112,20,3,287,289,2
during-20-1112,20,3,297,298,1
during-20-1112,20,3,323,325,2
during-20-1112,20,3,328,331,3
during-20-1112,20,3,339,341,2
during-20-1112,20,4,19,24,5
during-20-1112,20,4,29,30,1
during-20-1112,20,4,39,40,1
during-20-1112,20,4,50,56,6
during-20-1112,20,4,65,69,4
during-20-1112,20,4,72,75,3
during-20-1112,20,4,80,82,2
during-20-1112,20,4,95,96,1
during-20-1112,20,4,128,155,27
during-20-1112,20,4,164,170,6
during-20-1112,20,4,181,186,5
during-20-1112,20,4,218,219,1
during-20-1112,20,4,276,280,4
during-20-1112,20,4,317,324,7
during-20-1112,20,4,351,353,2
during-20-1112,20,5,8,10,2
during-20-1112,20,5,28,41,13
during-20-1112,20,5,57,70,13
during-20-1112,20,5,133,141,8
during-20-1112,20,5,148,153,5
during-20-1112,20,5,216,220,4
during-20-1112,20,5,252,253,1
during-20-1112,20,5,277,283,6
during-20-1112,20,5,316,319,3
during-20-1112,20,5,321,329,8
during-20-1112,20,5,351,353,2
during-20-1112,20,5,367,371,4
during-20-1112,20,6,0,4,4
during-20-1112,20,6,20,24,4
during-20-1112,20,6,29,33,4
during-20-1112,20,6,39,41,2
during-20-1112,20,6,56,68,12
during-20-1112,20,6,130,136,6
during-20-1112,20,6,138,140,2
during-20-1112,20,6,151,153,2
during-20-1112,20,6,160,161,1
during-20-1112,20,6,209,210,1
during-20-1112,20,6,218,219,1
during-20-1112,20,6,253,257,4
during-20-1112,20,6,276,287,11
during-20-1112,20,6,317,324,7
during-20-1112,20,7,7,10,3
during-20-1112,20,7,20,26,6
during-20-1112,20,7,37,41,4
during-20-1112,20,7,56,68,12
during-20-1112,20,7,72,73,1
during-20-1112,20,7,79,84,5
during-20-1112,20,7,131,135,4
during-20-1112,20,7,136,155,19
during-20-1112,20,7,159,161,2
during-20-1112,20,7,182,186,4
during-20-1112,20,7,207,212,5
during-20-1112,20,7,217,225,8
during-20-1112,20,7,268,269,1
during-20-1112,20,7,319,328,9
during-20-1112,20,7,353,355,2
during-20-1112,20,8,19,27,8
during-20-1112,20,8,28,38,10
during-20-1112,20,8,39,45,6
during-20-1112,20,8,73,74,1
during-20-1112,20,8,106,108,2
during-20-1112,20,8,130,155,25
during-20-1112,20,8,218,221,3
during-20-1112,20,8,251,256,5
during-20-1112,20,8,274,275,1
during-20-1112,20,8,279,280,1
during-20-1112,20,8,319,323,4
during-20-1112,20,8,326,330,4
during-20-1112,20,8,344,346,2
during-20-1112,20,8,377,378,1
during-20-1112,20,8,384,396,12
during-20-1112,20,9,0,4,4
during-20-1112,20,9,19,31,12
during-20-1112,20,9,37,40,3
during-20-1112,20,9,49,54,5
during-20-1112,20,9,57,62,5
during-20-1112,20,9,68,69,1
during-20-1112,20,9,73,74,1
during-20-1112,20,9,130,155,25
during-20-1112,20,9,182,184,2
during-20-1112,20,9,193,198,5
during-20-1112,20,9,219,227,8
during-20-1112,20,9,274,278,4
during-20-1112,20,9,286,288,2
during-20-1112,20,9,309,316,7
during-20-1112,20,9,318,325,7
during-20-1112,20,9,336,360,24
during-20-1112,20,9,391,396,5
during-20-1112,20,10,3,4,1
during-20-1112,20,10,14,16,2
during-20-1112,20,10,37,44,7
during-20-1112,20,10,46,53,7
during-20-1112,20,10,56,60,4
during-20-1112,20,10,62,65,3
during-20-1112,20,10,66,68,2
during-20-1112,20,10,69,70,1
during-20-1112,20,10,72,74,2
during-20-1112,20,10,79,83,4
during-20-1112,20,10,95,97,2
during-20-1112,20,10,106,112,6
during-20-1112,20,10,130,141,11
during-20-1112,20,10,146,147,1
during-20-1112,20,10,148,155,7
during-20-1112,20,10,160,161,1
during-20-1112,20,10,192,198,6
during-20-1112,20,10,210,212,2
during-20-1112,20,10,217,221,4
during-20-1112,20,10,266,267,1
during-20-1112,20,10,277,279,2
during-20-1112,20,11,9,15,6
during-20-1112,20,11,20,41,21
during-20-1112,20,11,56,64,8
during-20-1112,20,11,65,68,3
during-20-1112,20,11,128,132,4
during-20-1112,20,11,134,135,1
during-20-1112,20,11,136,140,4
during-20-1112,20,11,151,153,2
during-20-1112,20,11,178,183,5
during-20-1112,20,11,217,219,2
during-20-1112,20,11,253,283,30
during-20-1112,20,11,327,328,1
during-20-1112,20,11,377,378,1
during-20-1112,20,11,384,396,12
during-20-1112,20,12,17,25,8
during-20-1112,20,12,28,40,12
during-20-1112,20,12,41,42,1
during-20-1112,20,12,49,50,1
during-20-1112,20,12,63,67,4
during-20-1112,20,12,74,82,8
during-20-1112,20,12,123,124,1
during-20-1112,20,12,132,153,21
during-20-1112,20,12,182,184,2
during-20-1112,20,12,190,191,1
during-20-1112,20,12,216,220,4
during-20-1112,20,12,296,297,1
during-20-1112,20,12,318,326,8
during-20-1112,20,13,12,16,4
during-20-1112,20,13,18,22,4
during-20-1112,20,13,31,39,8
during-20-1112,20,13,63,68,5
during-20-1112,20,13,108,113,5
during-20-1112,20,13,123,125,2
during-20-1112,20,13,129,132,3
during-20-1112,20,13,136,154,18
during-20-1112,20,13,161,163,2
during-20-1112,20,13,273,278,5
during-20-1112,20,13,279,280,1
during-20-1112,20,13,299,300,1
during-20-1112,20,13,305,314,9
during-20-1112,20,13,317,324,7
during-20-1112,20,13,335,341,6
during-20-1112,20,13,377,379,2
during-20-1112,20,13,386,396,10
during-20-1112,20,14,12,15,3
during-20-1112,20,14,37,39,2
during-20-1112,20,14,42,43,1
during-20-1112,20,14,47,54,7
during-20-1112,20,14,57,68,11
during-20-1112,20,14,129,130,1
during-20-1112,20,14,132,143,11
during-20-1112,20,14,147,155,8
during-20-1112,20,14,160,161,1
during-20-1112,20,14,182,185,3
during-20-1112,20,14,217,222,5
during-20-1112,20,14,236,240,4
during-20-1112,20,14,247,258,11
during-20-1112,20,14,278,288,10
during-20-1112,20,14,297,298,1
during-20-1112,20,14,317,323,6
during-20-1112,20,15,20,23,3
during-20-1112,20,15,33,43,10
during-20-1112,20,15,44,45,1
during-20-1112,20,15,56,68,12
during-20-1112,20,15,72,73,1
during-20-1112,20,15,108,113,5
during-20-1112,20,15,129,132,3
during-20-1112,20,15,134,155,21
during-20-1112,20,15,164,168,4
during-20-1112,20,15,181,187,6
during-20-1112,20,15,192,194,2
during-20-1112,20,15,218,222,4
during-20-1112,20,15,253,259,6
during-20-1112,20,15,276,282,6
during-20-1112,20,15,285,286,1
during-20-1112,20,15,318,323,5
during-20-1112,20,15,376,379,3
during-20-1112,20,15,387,395,8
during-20-1112,20,15,413,414,1
during-20-1112,20,16,9,12,3
during-20-1112,20,16,20,24,4
during-20-1112,20,16,27,33,6
during-20-1112,20,16,63,68,5
during-20-1112,20,16,135,154,19
during-20-1112,20,16,194,197,3
during-20-1112,20,16,216,219,3
during-20-1112,20,16,249,250,1
during-20-1112,20,16,271,283,12
during-20-1112,20,16,304,305,1
during-20-1112,20,16,317,328,11
during-20-1112,20,17,26,41,15
during-20-1112,20,17,56,69,13
during-20-1112,20,17,81,83,2
during-20-1112,20,17,130,135,5
during-20-1112,20,17,136,140,4
during-20-1112,20,17,151,155,4
during-20-1112,20,17,160,162,2
during-20-1112,20,17,181,185,4
during-20-1112,20,17,217,219,2
during-20-1112,20,17,225,229,4
during-20-1112,20,17,287,288,1
during-20-1112,20,17,315,324,9
during-20-1112,20,17,337,342,5
during-20-1112,20,17,346,347,1
during-20-1112,20,17,386,397,11
during-20-1112,20,18,36,45,9
during-20-1112,20,18,47,50,3
during-20-1112,20,18,57,69,12
during-20-1112,20,18,128,153,25
during-20-1112,20,18,160,161,1
during-20-1112,20,18,182,187,5
during-20-1112,20,18,216,221,5
during-20-1112,20,18,275,282,7
during-20-1112,20,18,310,312,2
during-20-1112,20,18,318,325,7
during-20-1112,20,18,377,379,2
during-20-1112,20,18,387,397,10
during-20-1112,20,19,2,4,2
during-20-1112,20,19,26,31,5
during-20-1112,20,19,40,45,5
during-20-1112,20,19,59,69,10
during-20-1112,20,19,79,81,2
during-20-1112,20,19,130,152,22
during-20-1112,20,19,154,156,2
during-20-1112,20,19,216,221,5
during-20-1112,20,19,275,288,13
during-20-1112,20,19,308,312,4
during-20-1112,20,19,317,324,7
during-20-1112,20,19,376,378,2
during-20-1112,20,19,414,416,2
during-20-0912,20,0,0,3,3
during-20-0912,20,0,23,30,7
during-20-0912,20,0,39,46,7
during-20-0912,20,0,60,77,17
during-20-0912,20,0,114,127,13
during-20-0912,20,0,131,134,3
during-20-0912,20,0,150,153,3
during-20-0912,20,0,159,164,5
during-20-0912,20,0,198,211,13
during-20-0912,20,0,258,260,2
during-20-0912,20,0,267,268,1
during-20-0912,20,0,273,277,4
during-20-0912,20,0,285,314,29
during-20-0912,20,0,337,342,5
during-20-0912,20,0,357,358,1
during-20-0912,20,0,364,366,2
during-20-0912,20,0,368,369,1
during-20-0912,20,0,403,404,1
during-20-0912,20,1,1,3,2
during-20-0912,20,1,22,30,8
during-20-0912,20,1,39,47,8
during-20-0912,20,1,57,58,1
during-20-0912,20,1,60,67,7
during-20-0912,20,1,70,77,7
during-20-0912,20,1,116,127,11
during-20-0912,20,1,131,138,7
during-20-0912,20,1,147,148,1
during-20-0912,20,1,151,153,2
during-20-0912,20,1,158,159,1
during-20-0912,20,1,160,166,6
during-20-0912,20,1,194,197,3
during-20-0912,20,1,198,214,16
during-20-0912,20,1,256,257,1
during-20-0912,20,1,259,260,1
during-20-0912,20,1,263,266,3
during-20-0912,20,1,267,270,3
during-20-0912,20,1,287,289,2
during-20-0912,20,1,297,309,12
during-20-0912,20,1,311,313,2
during-20-0912,20,1,339,342,3
during-20-0912,20,1,357,371,14
during-20-0912,20,1,398,400,2
during-20-0912,20,1,402,404,2
during-20-0912,20,1,409,415,6
during-20-0912,20,2,1,3,2
during-20-0912,20,2,25,32,7
during-20-0912,20,2,39,48,9
during-20-0912,20,2,66,68,2
during-20-0912,20,2,69,76,7
during-20-0912,20,2,85,91,6
during-20-0912,20,2,117,126,9
during-20-0912,20,2,134,136,2
during-20-0912,20,2,149,155,6
during-20-0912,20,2,161,162,1
during-20-0912,20,2,163,165,2
during-20-0912,20,2,174,176,2
during-20-0912,20,2,197,200,3
during-20-0912,20,2,202,211,9
during-20-0912,20,2,252,256,4
during-20-0912,20,2,258,266,8
during-20-0912,20,2,282,290,8
during-20-0912,20,2,295,300,5
during-20-0912,20,2,330,338,8
during-20-0912,20,2,340,342,2
during-20-0912,20,2,345,349,4
during-20-0912,20,2,363,366,3
during-20-0912,20,2,380,387,7
during-20-0912,20,2,399,404,5
during-20-0912,20,3,0,2,2
during-20-0912,20,3,4,5,1
during-20-0912,20,3,6,8,2
during-20-0912,20,3,23,31,8
during-20-0912,20,3,38,46,8
during-20-0912,20,3,47,50,3
during-20-0912,20,3,60,68,8
during-20-0912,20,3,71,79,8
during-20-0912,20,3,99,101,2
during-20-0912,20,3,114,115,1
during-20-0912,20,3,116,126,10
during-20-0912,20,3,131,139,8
during-20-0912,20,3,143,149,6
during-20-0912,20,3,150,154,4
during-20-0912,20,3,159,163,4
during-20-0912,20,3,174,176,2
during-20-0912,20,3,197,208,11
during-20-0912,20,3,211,212,1
during-20-0912,20,3,257,258,1
during-20-0912,20,3,263,266,3
during-20-0912,20,3,296,319,23
during-20-0912,20,3,344,350,6
during-20-0912,20,3,356,358,2
during-20-0912,20,3,369,371,2
during-20-0912,20,3,372,377,5
during-20-0912,20,3,379,386,7
during-20-0912,20,4,0,2,2
during-20-0912,20,4,20,28,8
during-20-0912,20,4,39,48,9
during-20-0912,20,4,57,60,3
during-20-0912,20,4,77,79,2
during-20-0912,20,4,86,91,5
during-20-0912,20,4,117,123,6
during-20-0912,20,4,125,127,2
during-20-0912,20,4,133,135,2
during-20-0912,20,4,136,139,3
during-20-0912,20,4,150,154,4
during-20-0912,20,4,159,165,6
during-20-0912,20,4,193,198,5
during-20-0912,20,4,212,213,1
during-20-0912,20,4,222,226,4
during-20-0912,20,4,256,257,1
during-20-0912,20,4,259,267,8
during-20-0912,20,4,359,361,2
during-20-0912,20,4,362,367,5
during-20-0912,20,4,385,388,3
during-20-0912,20,5,0,3,3
during-20-0912,20,5,25,29,4
during-20-0912,20,5,38,39,1
during-20-0912,20,5,41,47,6
during-20-0912,20,5,58,60,2
during-20-0912,20,5,65,68,3
during-20-0912,20,5,69,75,6
during-20-0912,20,5,114,127,13
during-20-0912,20,5,151,154,3
during-20-0912,20,5,159,165,6
during-20-0912,20,5,172,177,5
during-20-0912,20,5,180,181,1
during-20-0912,20,5,198,211,13
during-20-0912,20,5,254,255,1
during-20-0912,20,5,258,266,8
during-20-0912,20,5,268,269,1
during-20-0912,20,5,352,361,9
during-20-0912,20,5,403,415,12
during-20-0912,20,6,0,4,4
during-20-0912,20,6,23,32,9
during-20-0912,20,6,39,54,15
during-20-0912,20,6,61,62,1
during-20-0912,20,6,77,82,5
during-20-0912,20,6,115,117,2
during-20-0912,20,6,123,126,3
during-20-0912,20,6,150,153,3
during-20-0912,20,6,160,162,2
during-20-0912,20,6,197,212,15
during-20-0912,20,6,214,219,5
during-20-0912,20,6,259,264,5
during-20-0912,20,6,265,268,3
during-20-0912,20,6,357,361,4
during-20-0912,20,6,363,368,5
during-20-0912,20,6,381,387,6
during-20-0912,20,6,396,399,3
during-20-0912,20,6,402,405,3
during-20-0912,20,6,406,408,2
during-20-0912,20,7,0,3,3
during-20-0912,20,7,23,29,6
during-20-0912,20,7,40,47,7
during-20-0912,20,7,52,54,2
during-20-0912,20,7,59,66,7
during-20-0912,20,7,74,79,5
during-20-0912,20,7,97,99,2
during-20-0912,20,7,101,103,2
during-20-0912,20,7,106,111,5
during-20-0912,20,7,118,127,9
during-20-0912,20,7,145,148,3
during-20-0912,20,7,150,154,4
during-20-0912,20,7,158,161,3
during-20-0912,20,7,164,165,1
during-20-0912,20,7,201,208,7
during-20-0912,20,7,210,212,2
during-20-0912,20,7,259,262,3
during-20-0912,20,7,265,266,1
during-20-0912,20,7,267,269,2
during-20-0912,20,7,357,366,9
during-20-0912,20,7,370,371,1
during-20-0912,20,7,374,375,1
during-20-0912,20,7,382,388,6
during-20-0912,20,7,399,405,6
during-20-0912,20,8,0,2,2
during-20-0912,20,8,23,29,6
during-20-0912,20,8,39,47,8
during-20-0912,20,8,57,59,2
during-20-0912,20,8,61,66,5
during-20-0912,20,8,68,77,9
during-20-0912,20,8,101,104,3
during-20-0912,20,8,117,123,6
during-20-0912,20,8,124,127,3
during-20-0912,20,8,149,154,5
during-20-0912,20,8,157,159,2
during-20-0912,20,8,161,169,8
during-20-0912,20,8,199,212,13
during-20-0912,20,8,225,229,4
during-20-0912,20,8,245,249,4
during-20-0912,20,8,258,266,8
during-20-0912,20,8,290,293,3
during-20-0912,20,8,299,301,2
during-20-0912,20,8,317,325,8
during-20-0912,20,8,332,333,1
during-20-0912,20,8,363,369,6
during-20-0912,20,8,385,388,3
during-20-0912,20,8,399,405,6
during-20-0912,20,9,0,4,4
during-20-0912,20,9,25,30,5
during-20-0912,20,9,38,47,9
during-20-0912,20,9,50,53,3
during-20-0912,20,9,63,68,5
during-20-0912,20,9,70,77,7
during-20-0912,20,9,99,102,3
during-20-0912,20,9,116,127,11
during-20-0912,20,9,149,154,5
during-20-0912,20,9,158,165,7
during-20-0912,20,9,198,212,14
during-20-0912,20,9,224,225,1
during-20-0912,20,9,255,257,2
during-20-0912,20,9,258,260,2
during-20-0912,20,9,261,266,5
during-20-0912,20,9,295,300,5
during-20-0912,20,9,316,327,11
during-20-0912,20,9,356,367,11
during-20-0912,20,9,373,378,5
during-20-0912,20,9,384,389,5
during-20-0912,20,9,402,404,2
during-20-0912,20,10,0,3,3
during-20-0912,20,10,25,30,5
during-20-0912,20,10,42,46,4
during-20-0912,20,10,53,54,1
during-20-0912,20,10,58,61,3
during-20-0912,20,10,62,68,6
during-20-0912,20,10,70,71,1
during-20-0912,20,10,72,77,5
during-20-0912,20,10,117,122,5
during-20-0912,20,10,123,127,4
during-20-0912,20,10,133,139,6
during-20-0912,20,10,150,153,3
during-20-0912,20,10,158,161,3
during-20-0912,20,10,198,212,14
during-20-0912,20,10,223,225,2
during-20-0912,20,10,250,256,6
during-20-0912,20,10,259,268,9
during-20-0912,20,10,287,293,6
during-20-0912,20,10,363,366,3
during-20-0912,20,10,379,381,2
during-20-0912,20,10,385,386,1
during-20-0912,20,10,400,405,5
during-20-0912,20,11,0,3,3
during-20-0912,20,11,24,29,5
during-20-0912,20,11,30,32,2
during-20-0912,20,11,38,45,7
during-20-0912,20,11,46,47,1
during-20-0912,20,11,52,54,2
during-20-0912,20,11,61,69,8
during-20-0912,20,11,71,78,7
during-20-0912,20,11,86,92,6
during-20-0912,20,11,117,126,9
during-20-0912,20,11,132,137,5
during-20-0912,20,11,149,153,4
during-20-0912,20,11,158,168,10
during-20-0912,20,11,172,178,6
during-20-0912,20,11,198,213,15
during-20-0912,20,11,263,268,5
during-20-0912,20,11,286,290,4
during-20-0912,20,11,295,300,5
during-20-0912,20,11,332,342,10
during-20-0912,20,11,356,362,6
during-20-0912,20,11,363,367,4
during-20-0912,20,11,385,388,3
during-20-0912,20,11,402,406,4
during-20-0912,20,11,409,412,3
during-20-0912,20,12,0,4,4
during-20-0912,20,12,8,10,2
during-20-0912,20,12,23,30,7
during-20-0912,20,12,36,55,19
during-20-0912,20,12,60,70,10
during-20-0912,20,12,71,77,6
during-20-0912,20,12,109,110,1
during-20-0912,20,12,117,126,9
during-20-0912,20,12,132,136,4
during-20-0912,20,12,150,155,5
during-20-0912,20,12,160,166,6
during-20-0912,20,12,172,176,4
during-20-0912,20,12,198,210,12
during-20-0912,20,12,259,266,7
during-20-0912,20,12,268,269,1
during-20-0912,20,12,275,284,9
during-20-0912,20,12,362,366,4
during-20-0912,20,12,384,389,5
during-20-0912,20,13,0,2,2
during-20-0912,20,13,23,27,4
during-20-0912,20,13,28,29,1
during-20-0912,20,13,40,45,5
during-20-0912,20,13,46,48,2
during-20-0912,20,13,62,68,6
during-20-0912,20,13,70,77,7
during-20-0912,20,13,117,121,4
during-20-0912,20,13,132,140,8
during-20-0912,20,13,150,155,5
during-20-0912,20,13,158,164,6
during-20-0912,20,13,198,211,13
during-20-0912,20,13,254,255,1
during-20-0912,20,13,258,268,10
during-20-0912,20,13,278,280,2
during-20-0912,20,13,281,284,3
during-20-0912,20,13,315,319,4
during-20-0912,20,13,345,350,5
during-20-0912,20,13,352,353,1
during-20-0912,20,13,357,361,4
during-20-0912,20,13,373,377,4
during-20-0912,20,13,401,407,6
during-20-0912,20,13,417,419,2
during-20-0912,20,14,0,4,4
during-20-0912,20,14,23,29,6
during-20-0912,20,14,40,48,8
during-20-0912,20,14,59,60,1
during-20-0912,20,14,66,68,2
during-20-0912,20,14,71,78,7
during-20-0912,20,14,85,90,5
during-20-0912,20,14,101,102,1
during-20-0912,20,14,117,126,9
during-20-0912,20,14,131,136,5
during-20-0912,20,14,148,149,1
during-20-0912,20,14,151,152,1
during-20-0912,20,14,153,154,1
during-20-0912,20,14,160,165,5
during-20-0912,20,14,197,210,13
during-20-0912,20,14,212,213,1
during-20-0912,20,14,234,237,3
during-20-0912,20,14,261,268,7
during-20-0912,20,14,287,291,4
during-20-0912,20,14,296,302,6
during-20-0912,20,14,344,349,5
during-20-0912,20,14,362,366,4
during-20-0912,20,14,382,386,4
during-20-0912,20,15,0,4,4
during-20-0912,20,15,23,30,7
during-20-0912,20,15,40,55,15
during-20-0912,20,15,57,68,11
during-20-0912,20,15,70,78,8
during-20-0912,20,15,98,101,3
during-20-0912,20,15,117,128,11
during-20-0912,20,15,149,154,5
during-20-0912,20,15,158,161,3
during-20-0912,20,15,172,175,3
during-20-0912,20,15,197,212,15
during-20-0912,20,15,224,226,2
during-20-0912,20,15,237,256,19
during-20-0912,20,15,258,263,5
during-20-0912,20,15,283,284,1
during-20-0912,20,15,288,298,10
during-20-0912,20,15,332,336,4
during-20-0912,20,15,347,349,2
during-20-0912,20,16,0,5,5
during-20-0912,20,16,23,30,7
during-20-0912,20,16,38,39,1
during-20-0912,20,16,41,48,7
during-20-0912,20,16,54,55,1
during-20-0912,20,16,59,65,6
during-20-0912,20,16,75,76,1
during-20-0912,20,16,87,91,4
during-20-0912,20,16,107,112,5
during-20-0912,20,16,115,116,1
during-20-0912,20,16,120,126,6
during-20-0912,20,16,131,139,8
during-20-0912,20,16,149,155,6
during-20-0912,20,16,159,167,8
during-20-0912,20,16,198,212,14
during-20-0912,20,16,235,238,3
during-20-0912,20,16,257,266,9
during-20-0912,20,16,267,268,1
during-20-0912,20,16,281,283,2
during-20-0912,20,16,386,390,4
during-20-0912,20,16,399,404,5
during-20-0912,20,17,2,7,5
during-20-0912,20,17,19,23,4
during-20-0912,20,17,38,48,10
during-20-0912,20,17,59,68,9
during-20-0912,20,17,73,78,5
during-20-0912,20,17,85,92,7
during-20-0912,20,17,99,100,1
during-20-0912,20,17,115,122,7
during-20-0912,20,17,124,127,3
during-20-0912,20,17,132,134,2
during-20-0912,20,17,151,154,3
during-20-0912,20,17,160,164,4
during-20-0912,20,17,180,182,2
during-20-0912,20,17,197,210,13
during-20-0912,20,17,211,212,1
during-20-0912,20,17,231,233,2
during-20-0912,20,17,234,235,1
during-20-0912,20,17,256,257,1
during-20-0912,20,17,259,266,7
during-20-0912,20,17,267,269,2
during-20-0912,20,17,347,362,15
during-20-0912,20,17,363,367,4
during-20-0912,20,17,385,388,3
during-20-0912,20,17,395,398,3
during-20-0912,20,17,406,411,5
during-20-0912,20,18,5,8,3
during-20-0912,20,18,23,28,5
during-20-0912,20,18,39,54,15
during-20-0912,20,18,60,66,6
during-20-0912,20,18,77,79,2
during-20-0912,20,18,117,118,1
during-20-0912,20,18,124,127,3
during-20-0912,20,18,130,135,5
during-20-0912,20,18,149,154,5
during-20-0912,20,18,159,165,6
during-20-0912,20,18,198,212,14
during-20-0912,20,18,221,225,4
during-20-0912,20,18,245,249,4
during-20-0912,20,18,255,257,2
during-20-0912,20,18,258,259,1
during-20-0912,20,18,260,266,6
during-20-0912,20,18,289,319,30
during-20-0912,20,18,372,373,1
during-20-0912,20,18,389,390,1
during-20-0912,20,18,402,407,5
during-20-0912,20,19,2,4,2
during-20-0912,20,19,23,30,7
during-20-0912,20,19,39,54,15
during-20-0912,20,19,59,60,1
during-20-0912,20,19,68,69,1
during-20-0912,20,19,71,77,6
during-20-0912,20,19,101,102,1
during-20-0912,20,19,115,117,2
during-20-0912,20,19,124,126,2
during-20-0912,20,19,132,139,7
during-20-0912,20,19,149,154,5
during-20-0912,20,19,159,165,6
during-20-0912,20,19,198,212,14
during-20-0912,20,19,255,256,1
during-20-0912,20,19,259,260,1
during-20-0912,20,19,261,268,7
during-20-0912,20,19,309,314,5
during-20-0912,20,19,315,321,6
during-20-0912,20,19,360,361,1
during-20-0912,20,19,363,366,3
during-20-0912,20,19,380,381,1
during-20-0912,20,19,382,388,6
during-20-0912,20,19,399,404,5
during-20-0612,20,0,20,21,1
during-20-0612,20,0,69,73,4
during-20-0612,20,0,93,97,4
during-20-0612,20,0,100,101,1
during-20-0612,20,0,143,144,1
during-20-0612,20,0,156,159,3
during-20-0612,20,0,168,171,3
during-20-0612,20,0,173,183,10
during-20-0612,20,0,214,220,6
during-20-0612,20,0,242,246,4
during-20-0612,20,0,292,293,1
during-20-0612,20,0,297,299,2
during-20-0612,20,0,310,315,5
during-20-0612,20,0,317,319,2
during-20-0612,20,0,329,330,1
during-20-0612,20,0,332,334,2
during-20-0612,20,0,369,371,2
during-20-0612,20,0,377,385,8
during-20-0612,20,0,399,408,9
during-20-0612,20,1,92,96,4
during-20-0612,20,1,167,182,15
during-20-0612,20,1,188,190,2
during-20-0612,20,1,242,247,5
during-20-0612,20,1,292,293,1
during-20-0612,20,1,295,298,3
during-20-0612,20,1,299,300,1
during-20-0612,20,1,301,305,4
during-20-0612,20,1,307,315,8
during-20-0612,20,1,319,320,1
during-20-0612,20,1,330,333,3
during-20-0612,20,1,340,345,5
during-20-0612,20,1,376,379,3
during-20-0612,20,1,382,385,3
during-20-0612,20,1,396,409,13
during-20-0612,20,2,93,96,3
during-20-0612,20,2,111,112,1
during-20-0612,20,2,169,182,13
during-20-0612,20,2,244,249,5
during-20-0612,20,2,307,315,8
during-20-0612,20,2,317,319,2
during-20-0612,20,2,357,360,3
during-20-0612,20,2,377,384,7
during-20-0612,20,2,386,387,1
during-20-0612,20,2,395,398,3
during-20-0612,20,2,402,404,2
during-20-0612,20,3,59,61,2
during-20-0612,20,3,168,181,13
during-20-0612,20,3,189,190,1
during-20-0612,20,3,243,248,5
during-20-0612,20,3,257,265,8
during-20-0612,20,3,284,287,3
during-20-0612,20,3,291,294,3
during-20-0612,20,3,311,315,4
during-20-0612,20,3,377,384,7
during-20-0612,20,3,402,408,6
during-20-0612,20,4,94,96,2
during-20-0612,20,4,168,176,8
during-20-0612,20,4,178,182,4
during-20-0612,20,4,188,190,2
during-20-0612,20,4,227,235,8
during-20-0612,20,4,243,247,4
during-20-0612,20,4,293,295,2
during-20-0612,20,4,315,316,1
during-20-0612,20,4,331,333,2
during-20-0612,20,4,376,387,11
during-20-0612,20,4,394,402,8
during-20-0612,20,4,403,409,6
during-20-0612,20,5,3,22,19
during-20-0612,20,5,93,97,4
during-20-0612,20,5,168,176,8
during-20-0612,20,5,180,182,2
during-20-0612,20,5,243,247,4
during-20-0612,20,5,293,294,1
during-20-0612,20,5,297,300,3
during-20-0612,20,5,309,315,6
during-20-0612,20,5,317,319,2
during-20-0612,20,5,383,386,3
during-20-0612,20,5,387,388,1
during-20-0612,20,5,392,409,17
during-20-0612,20,6,46,53,7
during-20-0612,20,6,68,75,7
during-20-0612,20,6,92,96,4
during-20-0612,20,6,128,130,2
during-20-0612,20,6,177,182,5
during-20-0612,20,6,215,221,6
during-20-0612,20,6,242,245,3
during-20-0612,20,6,283,285,2
during-20-0612,20,6,290,292,2
during-20-0612,20,6,303,304,1
during-20-0612,20,6,307,314,7
during-20-0612,20,6,316,318,2
during-20-0612,20,6,340,341,1
during-20-0612,20,6,376,385,9
during-20-0612,20,6,395,398,3
during-20-0612,20,6,402,408,6
during-20-0612,20,7,70,77,7
during-20-0612,20,7,91,95,4
during-20-0612,20,7,174,181,7
during-20-0612,20,7,186,189,3
during-20-0612,20,7,242,248,6
during-20-0612,20,7,271,278,7
during-20-0612,20,7,290,293,3
during-20-0612,20,7,303,305,2
during-20-0612,20,7,309,311,2
during-20-0612,20,7,376,384,8
during-20-0612,20,7,393,395,2
during-20-0612,20,7,401,408,7
during-20-0612,20,8,0,6,6
during-20-0612,20,8,54,57,3
during-20-0612,20,8,92,96,4
during-20-0612,20,8,103,105,2
during-20-0612,20,8,172,182,10
during-20-0612,20,8,189,190,1
during-20-0612,20,8,243,251,8
during-20-0612,20,8,293,295,2
during-20-0612,20,8,298,299,1
during-20-0612,20,8,308,313,5
during-20-0612,20,8,340,344,4
during-20-0612,20,8,377,380,3
during-20-0612,20,8,381,389,8
during-20-0612,20,8,398,400,2
during-20-0612,20,8,402,403,1
during-20-0612,20,8,404,406,2
during-20-0612,20,9,0,16,16
during-20-0612,20,9,38,44,6
during-20-0612,20,9,68,75,7
during-20-0612,20,9,93,96,3
during-20-0612,20,9,112,113,1
during-20-0612,20,9,168,181,13
during-20-0612,20,9,189,190,1
during-20-0612,20,9,243,247,4
during-20-0612,20,9,291,293,2
during-20-0612,20,9,307,308,1
during-20-0612,20,9,310,313,3
during-20-0612,20,9,316,320,4
during-20-0612,20,9,375,388,13
during-20-0612,20,9,392,396,4
during-20-0612,20,9,397,398,1
during-20-0612,20,9,402,409,7
during-20-0612,20,10,40,43,3
during-20-0612,20,10,180,181,1
during-20-0612,20,10,188,190,2
during-20-0612,20,10,244,247,3
during-20-0612,20,10,275,276,1
during-20-0612,20,10,308,311,3
during-20-0612,20,10,312,315,3
during-20-0612,20,10,319,320,1
during-20-0612,20,10,331,332,1
during-20-0612,20,10,378,388,10
during-20-0612,20,10,393,399,6
during-20-0612,20,10,401,408,7
during-20-0612,20,11,68,85,17
during-20-0612,20,11,93,95,2
during-20-0612,20,11,168,173,5
during-20-0612,20,11,176,183,7
during-20-0612,20,11,243,248,5
during-20-0612,20,11,272,275,3
during-20-0612,20,11,294,299,5
during-20-0612,20,11,302,303,1
during-20-0612,20,11,308,315,7
during-20-0612,20,11,376,384,8
during-20-0612,20,11,394,408,14
during-20-0612,20,12,4,21,17
during-20-0612,20,12,22,30,8
during-20-0612,20,12,94,96,2
during-20-0612,20,12,168,181,13
during-20-0612,20,12,244,248,4
during-20-0612,20,12,257,264,7
during-20-0612,20,12,309,315,6
during-20-0612,20,12,376,386,10
during-20-0612,20,12,403,408,5
during-20-0612,20,12,414,417,3
during-20-0612,20,13,94,95,1
during-20-0612,20,13,99,100,1
during-20-0612,20,13,169,181,12
during-20-0612,20,13,187,191,4
during-20-0612,20,13,199,200,1
during-20-0612,20,13,242,248,6
during-20-0612,20,13,273,276,3
during-20-0612,20,13,291,294,3
during-20-0612,20,13,297,298,1
during-20-0612,20,13,330,334,4
during-20-0612,20,13,338,346,8
during-20-0612,20,13,377,389,12
during-20-0612,20,13,396,408,12
during-20-0612,20,14,33,57,24
during-20-0612,20,14,94,97,3
during-20-0612,20,14,168,173,5
during-20-0612,20,14,175,182,7
during-20-0612,20,14,243,247,4
during-20-0612,20,14,293,294,1
during-20-0612,20,14,307,315,8
during-20-0612,20,14,377,384,7
during-20-0612,20,14,401,408,7
during-20-0612,20,15,62,77,15
during-20-0612,20,15,94,97,3
during-20-0612,20,15,168,181,13
during-20-0612,20,15,243,248,5
during-20-0612,20,15,292,296,4
during-20-0612,20,15,311,315,4
during-20-0612,20,15,317,319,2
during-20-0612,20,15,392,414,22
during-20-0612,20,16,93,97,4
during-20-0612,20,16,170,181,11
during-20-0612,20,16,243,247,4
during-20-0612,20,16,292,294,2
during-20-0612,20,16,295,299,4
during-20-0612,20,16,310,315,5
during-20-0612,20,16,318,319,1
during-20-0612,20,16,369,371,2
during-20-0612,20,16,377,384,7
during-20-0612,20,16,396,409,13
during-20-0612,20,17,21,26,5
during-20-0612,20,17,94,97,3
during-20-0612,20,17,98,102,4
during-20-0612,20,17,106,108,2
during-20-0612,20,17,169,181,12
during-20-0612,20,17,187,191,4
during-20-0612,20,17,243,247,4
during-20-0612,20,17,301,306,5
during-20-0612,20,17,308,315,7
during-20-0612,20,17,317,320,3
during-20-0612,20,17,377,385,8
during-20-0612,20,17,401,410,9
during-20-0612,20,18,69,77,8
during-20-0612,20,18,93,97,4
during-20-0612,20,18,169,183,14
during-20-0612,20,18,188,190,2
during-20-0612,20,18,244,247,3
during-20-0612,20,18,309,315,6
during-20-0612,20,18,318,319,1
during-20-0612,20,18,372,373,1
during-20-0612,20,18,377,385,8
during-20-0612,20,18,394,395,1
during-20-0612,20,18,397,398,1
during-20-0612,20,18,401,407,6
during-20-0612,20,19,94,96,2
during-20-0612,20,19,98,101,3
during-20-0612,20,19,143,144,1
during-20-0612,20,19,168,181,13
during-20-0612,20,19,187,190,3
during-20-0612,20,19,243,247,4
during-20-0612,20,19,292,293,1
during-20-0612,20,19,308,315,7
during-20-0612,20,19,318,320,2
during-20-0612,20,19,376,385,9
during-20-0612,20,19,401,407,6
during-20-0212,20,0,76,84,8
during-20-0212,20,0,86,89,3
during-20-0212,20,0,296,297,1
during-20-0212,20,0,302,316,14
during-20-0212,20,0,340,342,2
during-20-0212,20,0,343,344,1
during-20-0212,20,0,358,360,2
during-20-0212,20,0,382,385,3
during-20-0212,20,0,386,391,5
during-20-0212,20,0,397,410,13
during-20-0212,20,1,78,89,11
during-20-0212,20,1,248,250,2
during-20-0212,20,1,255,261,6
during-20-0212,20,1,270,271,1
during-20-0212,20,1,340,343,3
during-20-0212,20,1,364,374,10
during-20-0212,20,1,382,385,3
during-20-0212,20,1,387,391,4
during-20-0212,20,1,396,408,12
during-20-0212,20,2,76,88,12
during-20-0212,20,2,251,253,2
during-20-0212,20,2,255,259,4
during-20-0212,20,2,302,304,2
during-20-0212,20,2,330,334,4
during-20-0212,20,2,340,345,5
during-20-0212,20,2,361,363,2
during-20-0212,20,2,371,373,2
during-20-0212,20,2,383,386,3
during-20-0212,20,2,394,410,16
during-20-0212,20,3,78,89,11
during-20-0212,20,3,250,261,11
during-20-0212,20,3,294,296,2
during-20-0212,20,3,320,321,1
during-20-0212,20,3,330,335,5
during-20-0212,20,3,338,343,5
during-20-0212,20,3,358,359,1
during-20-0212,20,3,382,391,9
during-20-0212,20,3,393,398,5
during-20-0212,20,4,77,89,12
during-20-0212,20,4,249,252,3
during-20-0212,20,4,274,278,4
during-20-0212,20,4,305,331,26
during-20-0212,20,4,339,344,5
during-20-0212,20,4,382,408,26
during-20-0212,20,5,76,82,6
during-20-0212,20,5,86,89,3
during-20-0212,20,5,250,253,3
during-20-0212,20,5,277,279,2
during-20-0212,20,5,294,298,4
during-20-0212,20,5,343,344,1
during-20-0212,20,5,383,385,2
during-20-0212,20,5,389,391,2
during-20-0212,20,5,395,411,16
during-20-0212,20,6,76,86,10
during-20-0212,20,6,250,253,3
during-20-0212,20,6,256,258,2
during-20-0212,20,6,339,344,5
during-20-0212,20,6,358,359,1
during-20-0212,20,6,365,369,4
during-20-0212,20,6,371,372,1
during-20-0212,20,6,383,385,2
during-20-0212,20,6,388,392,4
during-20-0212,20,6,393,394,1
during-20-0212,20,6,397,409,12
during-20-0212,20,7,76,89,13
during-20-0212,20,7,254,261,7
during-20-0212,20,7,340,345,5
during-20-0212,20,7,358,359,1
during-20-0212,20,7,370,371,1
during-20-0212,20,7,389,393,4
during-20-0212,20,7,394,410,16
during-20-0212,20,7,415,419,4
during-20-0212,20,8,78,89,11
during-20-0212,20,8,249,255,6
during-20-0212,20,8,257,261,4
during-20-0212,20,8,296,301,5
during-20-0212,20,8,338,344,6
during-20-0212,20,8,383,385,2
during-20-0212,20,8,398,410,12
during-20-0212,20,9,77,84,7
during-20-0212,20,9,85,89,4
during-20-0212,20,9,256,260,4
during-20-0212,20,9,338,344,6
during-20-0212,20,9,365,366,1
during-20-0212,20,9,383,385,2
during-20-0212,20,9,386,388,2
during-20-0212,20,9,393,394,1
during-20-0212,20,9,396,410,14
during-20-0212,20,9,418,419,1
during-20-0212,20,10,76,85,9
during-20-0212,20,10,88,89,1
during-20-0212,20,10,274,275,1
during-20-0212,20,10,339,342,3
during-20-0212,20,10,360,361,1
during-20-0212,20,10,382,393,11
during-20-0212,20,10,401,411,10
during-20-0212,20,11,77,85,8
during-20-0212,20,11,86,88,2
during-20-0212,20,11,251,257,6
during-20-0212,20,11,260,261,1
during-20-0212,20,11,272,274,2
during-20-0212,20,11,294,297,3
during-20-0212,20,11,304,308,4
during-20-0212,20,11,319,321,2
during-20-0212,20,11,339,345,6
during-20-0212,20,11,362,363,1
during-20-0212,20,11,383,385,2
during-20-0212,20,11,387,388,1
during-20-0212,20,11,389,399,10
during-20-0212,20,11,401,403,2
during-20-0212,20,11,405,411,6
during-20-0212,20,12,76,89,13
during-20-0212,20,12,252,253,1
during-20-0212,20,12,274,275,1
during-20-0212,20,12,277,279,2
during-20-0212,20,12,342,347,5
during-20-0212,20,12,358,364,6
during-20-0212,20,12,383,388,5
during-20-0212,20,12,389,391,2
during-20-0212,20,12,393,409,16
during-20-0212,20,13,77,89,12
during-20-0212,20,13,252,256,4
during-20-0212,20,13,295,296,1
during-20-0212,20,13,304,309,5
during-20-0212,20,13,332,335,3
during-20-0212,20,13,340,344,4
during-20-0212,20,13,382,390,8
during-20-0212,20,13,393,410,17
during-20-0212,20,13,418,419,1
during-20-0212,20,14,76,88,12
during-20-0212,20,14,270,273,3
during-20-0212,20,14,340,344,4
during-20-0212,20,14,383,391,8
during-20-0212,20,14,392,410,18
during-20-0212,20,15,76,82,6
during-20-0212,20,15,87,89,2
during-20-0212,20,15,249,253,4
during-20-0212,20,15,255,261,6
during-20-0212,20,15,340,343,3
during-20-0212,20,15,359,362,3
during-20-0212,20,15,371,374,3
during-20-0212,20,15,382,385,3
during-20-0212,20,15,386,390,4
during-20-0212,20,15,397,408,11
during-20-0212,20,15,409,410,1
during-20-0212,20,16,76,89,13
during-20-0212,20,16,259,260,1
during-20-0212,20,16,270,271,1
during-20-0212,20,16,339,341,2
during-20-0212,20,16,343,344,1
during-20-0212,20,16,366,368,2
during-20-0212,20,16,382,385,3
during-20-0212,20,16,386,392,6
during-20-0212,20,16,393,410,17
during-20-0212,20,16,418,419,1
during-20-0212,20,17,76,88,12
during-20-0212,20,17,249,260,11
during-20-0212,20,17,273,277,4
during-20-0212,20,17,301,304,3
during-20-0212,20,17,340,344,4
during-20-0212,20,17,371,372,1
during-20-0212,20,17,382,392,10
during-20-0212,20,17,394,410,16
during-20-0212,20,18,76,89,13
during-20-0212,20,18,252,256,4
during-20-0212,20,18,295,304,9
during-20-0212,20,18,330,333,3
during-20-0212,20,18,341,344,3
during-20-0212,20,18,358,359,1
during-20-0212,20,18,370,373,3
during-20-0212,20,18,382,393,11
during-20-0212,20,18,398,410,12
during-20-0212,20,19,76,89,13
during-20-0212,20,19,257,259,2
during-20-0212,20,19,304,308,4
during-20-0212,20,19,339,340,1
during-20-0212,20,19,361,363,2
during-20-0212,20,19,365,366,1
during-20-0212,20,19,382,410,28
during-10-1212,10,0,80,86,6
during-10-1212,10,0,104,110,6
during-10-1212,10,0,134,135,1
during-10-1212,10,0,301,303,2
during-10-1212,10,1,0,2,2
during-10-1212,10,1,80,92,12
during-10-1212,10,1,301,303,2
during-10-1212,10,2,79,87,8
during-10-1212,10,2,107,115,8
during-10-1212,10,2,243,244,1
during-10-1212,10,2,249,250,1
during-10-1212,10,2,300,305,5
during-10-1212,10,3,0,1,1
during-10-1212,10,3,82,87,5
during-10-1212,10,3,107,115,8
during-10-1212,10,3,245,247,2
during-10-1212,10,3,300,303,3
during-10-1212,10,4,18,26,8
during-10-1212,10,4,80,86,6
during-10-1212,10,4,104,106,2
during-10-1212,10,4,281,298,17
during-10-1212,10,4,302,303,1
during-10-1212,10,5,0,1,1
during-10-1212,10,5,80,86,6
during-10-1212,10,5,229,237,8
during-10-1212,10,5,243,246,3
during-10-1212,10,5,301,303,2
during-10-1212,10,6,110,113,3
during-10-1212,10,6,249,251,2
during-10-1212,10,6,301,304,3
during-10-1212,10,7,107,108,1
during-10-1212,10,7,111,113,2
during-10-1212,10,7,134,136,2
during-10-1212,10,7,301,304,3
during-10-1212,10,8,0,1,1
during-10-1212,10,8,20,29,9
during-10-1212,10,8,107,113,6
during-10-1212,10,8,134,147,13
during-10-1212,10,8,246,249,3
during-10-1212,10,8,301,303,2
during-10-1212,10,9,0,1,1
during-10-1212,10,9,134,136,2
during-10-1212,10,9,281,283,2
during-10-3011,10,0,140,149,9
during-10-3011,10,0,168,175,7
during-10-3011,10,0,193,203,10
during-10-3011,10,0,257,259,2
during-10-3011,10,0,298,308,10
during-10-3011,10,0,379,404,25
during-10-3011,10,0,405,407,2
during-10-3011,10,1,140,150,10
during-10-3011,10,1,172,178,6
during-10-3011,10,1,193,202,9
during-10-3011,10,1,246,255,9
during-10-3011,10,1,260,262,2
during-10-3011,10,1,277,287,10
during-10-3011,10,1,297,304,7
during-10-3011,10,1,376,408,32
during-10-3011,10,1,409,410,1
during-10-3011,10,2,133,136,3
during-10-3011,10,2,140,149,9
during-10-3011,10,2,168,172,4
during-10-3011,10,2,199,212,13
during-10-3011,10,2,257,258,1
during-10-3011,10,2,291,294,3
during-10-3011,10,2,297,305,8
during-10-3011,10,2,374,406,32
during-10-3011,10,3,140,150,10
during-10-3011,10,3,168,172,4
during-10-3011,10,3,194,203,9
during-10-3011,10,3,255,258,3
during-10-3011,10,3,259,261,2
during-10-3011,10,3,278,279,1
during-10-3011,10,3,299,304,5
during-10-3011,10,3,333,341,8
during-10-3011,10,3,374,410,36
during-10-3011,10,4,0,13,13
during-10-3011,10,4,133,134,1
during-10-3011,10,4,140,150,10
during-10-3011,10,4,172,179,7
during-10-3011,10,4,256,258,2
during-10-3011,10,4,288,292,4
during-10-3011,10,4,297,304,7
during-10-3011,10,4,385,406,21
during-10-3011,10,4,409,410,1
during-10-3011,10,5,132,133,1
during-10-3011,10,5,141,150,9
during-10-3011,10,5,168,172,4
during-10-3011,10,5,173,176,3
during-10-3011,10,5,199,203,4
during-10-3011,10,5,256,258,2
during-10-3011,10,5,260,261,1
during-10-3011,10,5,298,305,7
during-10-3011,10,5,308,309,1
during-10-3011,10,5,375,407,32
during-10-3011,10,5,408,410,2
during-10-3011,10,6,0,19,19
during-10-3011,10,6,133,135,2
during-10-3011,10,6,140,150,10
during-10-3011,10,6,171,173,2
during-10-3011,10,6,199,204,5
during-10-3011,10,6,257,259,2
during-10-3011,10,6,298,308,10
during-10-3011,10,6,374,410,36
during-10-3011,10,7,3,12,9
during-10-3011,10,7,133,134,1
during-10-3011,10,7,140,150,10
during-10-3011,10,7,175,177,2
during-10-3011,10,7,193,196,3
during-10-3011,10,7,241,244,3
during-10-3011,10,7,257,258,1
during-10-3011,10,7,259,260,1
during-10-3011,10,7,261,262,1
during-10-3011,10,7,277,278,1
during-10-3011,10,7,279,282,3
during-10-3011,10,7,286,288,2
during-10-3011,10,7,296,305,9
during-10-3011,10,7,374,398,24
during-10-3011,10,7,401,407,6
during-10-3011,10,7,408,409,1
during-10-3011,10,8,3,5,2
during-10-3011,10,8,135,136,1
during-10-3011,10,8,141,150,9
during-10-3011,10,8,169,172,3
during-10-3011,10,8,192,198,6
during-10-3011,10,8,199,221,22
during-10-3011,10,8,256,259,3
during-10-3011,10,8,297,306,9
during-10-3011,10,8,385,390,5
during-10-3011,10,8,392,406,14
during-10-3011,10,8,407,410,3
during-10-3011,10,9,134,135,1
during-10-3011,10,9,140,150,10
during-10-3011,10,9,172,174,2
during-10-3011,10,9,175,178,3
during-10-3011,10,9,241,246,5
during-10-3011,10,9,256,259,3
during-10-3011,10,9,293,294,1
during-10-3011,10,9,298,304,6
during-10-3011,10,9,374,376,2
during-10-3011,10,9,385,411,26
during-10-0812,10,0,43,44,1
during-10-0812,10,0,71,79,8
during-10-0812,10,0,106,107,1
during-10-0812,10,0,113,116,3
during-10-0812,10,0,294,300,6
during-10-0812,10,0,360,363,3
during-10-0812,10,1,70,79,9
during-10-0812,10,1,106,109,3
during-10-0812,10,1,129,131,2
during-10-0812,10,1,194,211,17
during-10-0812,10,1,294,299,5
during-10-0812,10,1,314,317,3
during-10-0812,10,1,359,366,7
during-10-0812,10,2,38,39,1
during-10-0812,10,2,66,69,3
during-10-0812,10,2,70,78,8
during-10-0812,10,2,106,107,1
during-10-0812,10,2,294,295,1
during-10-0812,10,2,296,299,3
during-10-0812,10,2,314,315,1
during-10-0812,10,2,360,365,5
during-10-0812,10,3,32,33,1
during-10-0812,10,3,72,78,6
during-10-0812,10,3,107,108,1
during-10-0812,10,3,136,141,5
during-10-0812,10,3,216,220,4
during-10-0812,10,3,298,299,1
during-10-0812,10,3,327,330,3
during-10-0812,10,3,361,363,2
during-10-0812,10,4,64,65,1
during-10-0812,10,4,70,77,7
during-10-0812,10,4,79,80,1
during-10-0812,10,4,105,107,2
during-10-0812,10,4,294,300,6
during-10-0812,10,4,360,366,6
during-10-0812,10,5,70,78,8
during-10-0812,10,5,100,102,2
during-10-0812,10,5,106,110,4
during-10-0812,10,5,293,300,7
during-10-0812,10,5,359,360,1
during-10-0812,10,5,361,363,2
during-10-0812,10,6,14,19,5
during-10-0812,10,6,69,74,5
during-10-0812,10,6,77,79,2
during-10-0812,10,6,106,109,3
during-10-0812,10,6,266,268,2
during-10-0812,10,6,296,300,4
during-10-0812,10,6,311,315,4
during-10-0812,10,6,326,327,1
during-10-0812,10,6,360,366,6
during-10-0812,10,7,21,43,22
during-10-0812,10,7,71,78,7
during-10-0812,10,7,106,107,1
during-10-0812,10,7,113,115,2
during-10-0812,10,7,293,294,1
during-10-0812,10,7,297,300,3
during-10-0812,10,7,314,316,2
during-10-0812,10,7,360,364,4
during-10-0812,10,7,396,397,1
during-10-0812,10,8,71,76,5
during-10-0812,10,8,77,79,2
during-10-0812,10,8,106,109,3
during-10-0812,10,8,245,263,18
during-10-0812,10,8,294,295,1
during-10-0812,10,8,297,299,2
during-10-0812,10,8,361,362,1
during-10-0812,10,9,71,79,8
during-10-0812,10,9,107,108,1
during-10-0812,10,9,158,163,5
during-10-0812,10,9,297,300,3
during-10-0812,10,9,361,362,1
during-10-0312,10,0,6,25,19
during-10-0312,10,0,92,105,13
during-10-0312,10,0,116,119,3
during-10-0312,10,0,270,290,20
during-10-0312,10,0,327,328,1
during-10-0312,10,0,329,334,5
during-10-0312,10,1,5,24,19
during-10-0312,10,1,92,105,13
during-10-0312,10,1,116,119,3
during-10-0312,10,1,125,169,44
during-10-0312,10,1,292,294,2
during-10-0312,10,1,330,335,5
during-10-0312,10,2,6,25,19
during-10-0312,10,2,92,119,27
during-10-0312,10,2,161,166,5
during-10-0312,10,2,242,246,4
during-10-0312,10,2,292,294,2
during-10-0312,10,2,331,334,3
during-10-0312,10,3,6,25,19
during-10-0312,10,3,93,105,12
during-10-0312,10,3,117,118,1
during-10-0312,10,3,293,314,21
during-10-0312,10,3,327,334,7
during-10-0312,10,4,6,24,18
during-10-0312,10,4,92,105,13
during-10-0312,10,4,116,118,2
during-10-0312,10,4,183,190,7
during-10-0312,10,4,291,294,3
during-10-0312,10,4,295,296,1
during-10-0312,10,4,300,314,14
during-10-0312,10,4,328,334,6
during-10-0312,10,5,5,24,19
during-10-0312,10,5,67,75,8
during-10-0312,10,5,92,106,14
during-10-0312,10,5,115,119,4
during-10-0312,10,5,292,294,2
during-10-0312,10,5,327,334,7
during-10-0312,10,5,357,397,40
during-10-0312,10,6,6,25,19
during-10-0312,10,6,94,106,12
during-10-0312,10,6,116,119,3
during-10-0312,10,6,292,294,2
during-10-0312,10,6,330,334,4
during-10-0312,10,7,5,25,20
during-10-0312,10,7,92,106,14
during-10-0312,10,7,116,118,2
during-10-0312,10,7,162,165,3
during-10-0312,10,7,214,226,12
during-10-0312,10,7,292,294,2
during-10-0312,10,7,329,334,5
during-10-0312,10,8,2,3,1
during-10-0312,10,8,6,24,18
during-10-0312,10,8,92,106,14
during-10-0312,10,8,116,118,2
during-10-0312,10,8,292,294,2
during-10-0312,10,8,299,300,1
during-10-0312,10,8,327,335,8
during-10-0312,10,9,1,2,1
during-10-0312,10,9,6,25,19
during-10-0312,10,9,92,106,14
during-10-0312,10,9,117,119,2
during-10-0312,10,9,161,166,5
during-10-0312,10,9,292,294,2
during-10-0312,10,9,330,333,3
during-10-1312,10,0,19,20,1
during-10-1312,10,0,37,50,13
during-10-1312,10,0,58,62,4
during-10-1312,10,0,266,274,8
during-10-1312,10,0,278,300,22
during-10-1312,10,1,27,29,2
during-10-1312,10,1,32,36,4
during-10-1312,10,1,37,39,2
during-10-1312,10,1,41,46,5
during-10-1312,10,1,57,59,2
during-10-1312,10,1,75,77,2
during-10-1312,10,1,119,128,9
during-10-1312,10,1,134,141,7
during-10-1312,10,1,163,171,8
during-10-1312,10,1,268,271,3
during-10-1312,10,1,338,342,4
during-10-1312,10,2,6,7,1
during-10-1312,10,2,27,31,4
during-10-1312,10,2,32,39,7
during-10-1312,10,2,40,44,4
during-10-1312,10,2,47,49,2
during-10-1312,10,2,53,54,1
during-10-1312,10,2,55,57,2
during-10-1312,10,2,59,62,3
during-10-1312,10,2,106,128,22
during-10-1312,10,2,191,193,2
during-10-1312,10,2,267,275,8
during-10-1312,10,2,341,346,5
during-10-1312,10,2,383,385,2
during-10-1312,10,3,6,7,1
during-10-1312,10,3,18,20,2
during-10-1312,10,3,28,42,14
during-10-1312,10,3,51,53,2
during-10-1312,10,3,54,56,2
during-10-1312,10,3,271,275,4
during-10-1312,10,4,18,22,4
during-10-1312,10,4,30,31,1
during-10-1312,10,4,71,81,10
during-10-1312,10,4,267,274,7
during-10-1312,10,5,3,6,3
during-10-1312,10,5,27,33,6
during-10-1312,10,5,267,274,7
during-10-1312,10,5,392,396,4
during-10-1312,10,6,43,47,4
during-10-1312,10,6,50,61,11
during-10-1312,10,6,118,128,10
during-10-1312,10,6,266,275,9
during-10-1312,10,6,345,349,4
during-10-1312,10,7,6,7,1
during-10-1312,10,7,20,21,1
during-10-1312,10,7,39,49,10
during-10-1312,10,7,51,59,8
during-10-1312,10,7,60,62,2
during-10-1312,10,7,84,88,4
during-10-1312,10,7,220,223,3
during-10-1312,10,7,268,274,6
during-10-1312,10,7,340,350,10
during-10-1312,10,8,28,42,14
during-10-1312,10,8,50,61,11
during-10-1312,10,8,267,275,8
during-10-1312,10,9,28,43,15
during-10-1312,10,9,45,48,3
during-10-1312,10,9,266,275,9
during-5-2911,5,0,12,13,1
during-5-2911,5,0,49,90,41
during-5-2911,5,0,118,124,6
during-5-2911,5,2,10,12,2
during-5-2911,5,2,51,58,7
during-5-2911,5,2,86,91,5
during-5-2911,5,2,119,122,3
during-5-2911,5,2,123,125,2
during-5-2911,5,2,132,137,5
during-5-2911,5,2,201,210,9
during-5-2911,5,2,260,261,1
during-5-2911,5,2,262,263,1
during-5-2911,5,2,267,282,15
during-5-2911,5,2,368,369,1
during-5-2911,5,3,135,140,5
during-5-2911,5,3,202,210,8
during-5-2911,5,3,267,283,16
during-5-2911,5,3,367,369,2
during-5-2911,5,4,259,282,23
during-5-2911,5,4,368,369,1
during-5-0712,5,0,0,11,11
during-5-0712,5,0,35,46,11
during-5-0712,5,0,80,82,2
during-5-0712,5,0,101,118,17
during-5-0712,5,0,125,128,3
during-5-0712,5,0,134,135,1
during-5-0712,5,0,144,151,7
during-5-0712,5,0,156,157,1
during-5-0712,5,0,180,186,6
during-5-0712,5,0,222,224,2
during-5-0712,5,0,238,244,6
during-5-0712,5,0,246,250,4
during-5-0712,5,0,254,256,2
during-5-0712,5,0,276,285,9
during-5-0712,5,1,0,12,12
during-5-0712,5,1,35,47,12
during-5-0712,5,1,80,81,1
during-5-0712,5,1,125,134,9
during-5-0712,5,1,143,151,8
during-5-0712,5,1,156,159,3
during-5-0712,5,1,179,186,7
during-5-0712,5,1,223,224,1
during-5-0712,5,1,241,250,9
during-5-0712,5,1,275,286,11
during-5-0712,5,2,0,11,11
during-5-0712,5,2,35,46,11
during-5-0712,5,2,80,81,1
during-5-0712,5,2,117,118,1
during-5-0712,5,2,125,134,9
during-5-0712,5,2,144,145,1
during-5-0712,5,2,152,153,1
during-5-0712,5,2,179,186,7
during-5-0712,5,2,204,206,2
during-5-0712,5,2,239,258,19
during-5-0712,5,2,267,268,1
during-5-0712,5,2,275,285,10
during-5-0712,5,3,0,11,11
during-5-0712,5,3,35,47,12
during-5-0712,5,3,102,113,11
during-5-0712,5,3,124,137,13
during-5-0712,5,3,152,154,2
during-5-0712,5,3,179,186,7
during-5-0712,5,3,203,206,3
during-5-0712,5,3,239,250,11
during-5-0712,5,3,275,286,11
during-5-0712,5,3,352,364,12
during-5-0712,5,4,36,46,10
during-5-0712,5,4,80,81,1
during-5-0712,5,4,124,128,4
during-5-0712,5,4,143,151,8
during-5-0712,5,4,153,154,1
during-5-0712,5,4,156,157,1
during-5-0712,5,4,179,186,7
during-5-0712,5,4,203,206,3
during-5-0712,5,4,239,250,11
during-5-0712,5,4,276,285,9
during-5-0712,5,4,333,363,30
during-5-0712,5,4,366,370,4
during-5-0712,5,4,409,411,2
during-5-1412,5,0,0,5,5
during-5-1412,5,0,9,14,5
during-5-1412,5,0,16,21,5
during-5-1412,5,0,41,46,5
during-5-1412,5,0,158,169,11
during-5-1412,5,0,209,214,5
during-5-1412,5,0,226,231,5
during-5-1412,5,0,239,255,16
during-5-1412,5,0,269,271,2
during-5-1412,5,0,272,280,8
during-5-1412,5,0,293,407,114
during-5-1412,5,1,19,22,3
during-5-1412,5,1,48,49,1
during-5-1412,5,1,54,62,8
during-5-1412,5,1,96,102,6
during-5-1412,5,1,120,230,110
during-5-1412,5,1,233,236,3
during-5-1412,5,1,242,256,14
during-5-1412,5,1,269,271,2
during-5-1412,5,1,273,280,7
during-5-1412,5,1,289,292,3
during-5-1412,5,1,295,301,6
during-5-1412,5,1,309,341,32
during-5-1412,5,2,8,9,1
during-5-1412,5,2,16,22,6
during-5-1412,5,2,45,48,3
during-5-1412,5,2,188,205,17
during-5-1412,5,2,235,238,3
during-5-1412,5,2,241,256,15
during-5-1412,5,2,272,275,3
during-5-1412,5,3,16,22,6
during-5-1412,5,3,217,221,4
during-5-1412,5,3,238,241,3
during-5-1412,5,3,243,255,12
during-5-1412,5,3,269,271,2
during-5-1412,5,3,272,280,8
during-5-1412,5,3,308,340,32
during-5-1412,5,3,386,404,18
during-5-1412,5,3,410,417,7
during-5-1412,5,4,12,15,3
during-5-1412,5,4,17,23,6
during-5-1412,5,4,26,27,1
during-5-1412,5,4,42,45,3
during-5-1412,5,4,92,94,2
during-5-1412,5,4,129,212,83
during-5-1412,5,4,216,226,10
during-5-1412,5,4,233,236,3
during-5-1412,5,4,239,285,46
during-5-1412,5,4,337,345,8
during-5-1412,5,4,410,417,7
during-5-1012,5,0,32,33,1
during-5-1012,5,0,35,42,7
during-5-1012,5,0,347,396,49
during-5-1012,5,0,398,399,1
during-5-1012,5,1,0,4,4
during-5-1012,5,1,12,15,3
during-5-1012,5,1,25,42,17
during-5-1012,5,1,347,349,2
during-5-1012,5,1,350,394,44
during-5-1012,5,1,409,410,1
during-5-1012,5,2,11,12,1
during-5-1012,5,2,25,42,17
during-5-1012,5,2,121,124,3
during-5-1012,5,2,150,151,1
during-5-1012,5,2,226,255,29
during-5-1012,5,2,283,286,3
during-5-1012,5,2,347,395,48
during-5-1012,5,2,397,398,1
during-5-1012,5,2,408,409,1
during-5-1012,5,3,11,16,5
during-5-1012,5,3,32,35,3
during-5-1012,5,3,91,92,1
during-5-1012,5,3,346,394,48
during-5-1012,5,3,395,396,1
during-5-1012,5,3,408,411,3
during-5-1012,5,4,25,27,2
during-5-1012,5,4,40,42,2
during-5-1012,5,4,346,396,50
during-5-1012,5,4,409,411,2
during-5-0412,5,0,0,7,7
during-5-0412,5,0,79,94,15
during-5-0412,5,0,103,114,11
during-5-0412,5,0,129,153,24
during-5-0412,5,0,160,169,9
during-5-0412,5,0,179,188,9
during-5-0412,5,0,190,196,6
during-5-0412,5,0,252,260,8
during-5-0412,5,0,293,318,25
during-5-0412,5,0,354,360,6
during-5-0412,5,1,6,9,3
during-5-0412,5,1,80,97,17
during-5-0412,5,1,104,114,10
during-5-0412,5,1,130,153,23
during-5-0412,5,1,159,170,11
during-5-0412,5,1,180,189,9
during-5-0412,5,1,191,195,4
during-5-0412,5,1,252,260,8
during-5-0412,5,1,354,355,1
during-5-0412,5,1,356,359,3
during-5-0412,5,2,15,17,2
during-5-0412,5,2,81,96,15
during-5-0412,5,2,102,103,1
during-5-0412,5,2,104,114,10
during-5-0412,5,2,129,154,25
during-5-0412,5,2,159,169,10
during-5-0412,5,2,180,196,16
during-5-0412,5,2,252,260,8
during-5-0412,5,2,354,359,5
during-5-0412,5,3,6,10,4
during-5-0412,5,3,79,95,16
during-5-0412,5,3,103,114,11
during-5-0412,5,3,129,159,30
during-5-0412,5,3,160,169,9
during-5-0412,5,3,178,188,10
during-5-0412,5,3,190,195,5
during-5-0412,5,3,254,259,5
during-5-0412,5,3,354,359,5
during-5-0412,5,4,78,95,17
during-5-0412,5,4,102,114,12
during-5-0412,5,4,129,150,21
during-5-0412,5,4,158,169,11
during-5-0412,5,4,181,188,7
during-5-0412,5,4,192,196,4
during-5-0412,5,4,213,217,4
during-5-0412,5,4,252,260,8
during-5-0412,5,4,354,359,5